#############
#...........#
#...........#
#...........#
#...........#
#.....@.....#
#...........#
#...........#
#...........#
#...........#
#...........#
#...........#
#...........#
#...........#
####$$$$$####
...#11111#...
...#11111#...
...#22222#...
...#22222#...
...#33333#...
...#33333#...
...#44444#...
...#44444#...
...#55555#...
...#55555#...
...#66666#...
...#66666#...
...#77777#...
...#77777#...
...#88888#...
...#88888#...
...#99999#...
...#99999#...
...#######...

{
  "id": "tutorial1"
}

##############################################
#............................................#
#............................................#
#........................................#...#
#........................................#...#
#........................................#...#
#............................................#
#.............#########......................#
#............................................#
#............................................#
#..A.........................................#
#............................................#
#....A...................................#...#
#.........A..............................#...#
#........................................#...#
#.A..@..@................................#...#
#............................................#
#...#####.............########...............#
#............................................#
#............................................#
#............................................#
#............................................#
####################$$$$$#####################
...................#11111#....................
...................#11111#....................
...................#22222#....................
...................#22222#....................
...................#33333#....................
...................#33333#....................
...................#44444#....................
...................#44444#....................
...................#55555#....................
...................#55555#....................
...................#66666#....................
...................#66666#....................
...................#77777#....................
...................#77777#....................
...................#88888#....................
...................#88888#....................
...................#99999#....................
...................#99999#....................
...................#######....................

{
  "id": "test"
}
