##############################################
#............................................#
#............................................#
#........................................#...#
#........................................#...#
#........................................#...#
#............................................#
#.............#########......................#
#............................................#
#............................................#
#....@.......................................#
#............................................#
#........................................#...#
#........................................#...#
#........................................#...#
#........................................#...#
#............................................#
#...#####.............########...............#
#............................................#
#............................................#
#............................................#
#............................................#
##############################################

{
  "id": "test"
}
