##################
#................#
#....@...........#
#................#
#................#
##################

{
  "id": "test"
}
